####### ########
####### ########
####### ########
####### ########
######. $P.#####
######. ...#####
######. ....####
######. ..S$####
######. .$..####
                
######$ ....$.##
####... ......##
####... ......##
###...$ .##.$.##
###.... .##..$##
###$... .#######
###$... .#######
###...# ########
###...# ########
