##########
#P C  # E#
#  C  #  #
#B    #  #
#  ##### F#
#    #   #
# H  #   S#
##########