##############################
#  C  #   H   #      F       #
#  C  ##### B ########       #
#     # E # B #      #       #
#     #   # B #  EE  #       #
###### G ## B ########       #
#      # # B       P         #
#  E   # # B ########       #
#      #   H # S      F     #
##############################