##############################
#P-C--#---H---#------F-------#
#--C--#####-B-########-------#
#-----#-E-#-B-#------#-------#
#-----#---#-B-#--EE--#-------#
######-G-##-B-########-------#
#------#-#-B----------C-C-C--#
#--E---#-#-B-########-------#
#------#---H-#-S------F-----#
##############################