##########
#........#
#.######.#
#.#....#.#
#.#.##.#.#
#.#....#.#
#.######.#
#........#
#.######.#
##########

# = Wall
. = Empty space
